true
Hallo 1250
------ 100
------ 90
------ 80
------ 70
------ 60
------ 50
------ 40
------ 30
------ 20
